111111
1PCCC1
1CCCC1
1CCCC1
1CCCC1
1CCC01
111111