11111111111111
1P000000000001
11111111110001
10000000000001
10001111111111
1CCC0000000E01
11111111111111