111111
10CCC1
1CCCC1
1CCCC1
1CCCC1
1CCCE1
111110