111111
1PCCC1
1CCCC1
1CCCC1
1CCCC1
1CCCE1
1111111