111111
1CEP11
100101
1CCCC1
1CCCC1
1CCCC1
111111